0000000000000001000100000
0111110111110111010101110
0001000100010100010101000
1101011101011101110101110
0001000001000001000100010
0111111111111111011111010
0100000000010000010000010
0111011111010111111101111
0001010020010101000001000
1101110111010101110111010
0101000100010001000100010
0101011101111111010101110
0001010001000000010100010
0111011111011111011111010
0101000001010001000001010
0101011101011101110111010
0100000100000100010000010
0111111111110111011111110
0000000001000000000100010
1111111101111111111101010
0100010001000100000001010
0101010111010101111111010
0001010001010100000001000
0111011101010111111101110
0001000000010000000001000
