1000001000001000000000101
1011101111101011111010101
1010000000001010001010001
1011111111111011101011111
1000100000000010001000001
1010101111101110111110101
1010001000100000100010101
1011111010111110101011101
1010001020100010101000101
1010101110101011101110101
1010100010101000001000001
1011111010101111111111111
1000000010100000001000001
1111111010111111101011101
1000000010000000101010001
1011111111111110101010101
1000001000001000100010101
1111111011101011111110111
1000000010100010000010001
1011111110111110101011101
1010000000001000101000101
1011111011101011101110101
1010000010001000101010001
1010111110111111101011101
1000100000000000001000001
